"","couponID","nUser","nUserUsed","nUserTwiceorMore","nUserNotUsed"
"1","cpn1",2,0,0,2
"760","cpn2",2,1,0,1
"1358","cpn3",25,2,0,23
"1852","cpn7",11,2,0,9
"1932","cpn8",15,4,0,11
"2021","cpn9",5,0,0,5
"2","cpn10",6,1,0,5
"75","cpn11",20,5,0,15
"162","cpn12",1,1,0,0
"247","cpn13",7,1,0,6
"329","cpn14",11,0,0,11
"415","cpn15",4,1,0,3
"499","cpn16",8,5,0,3
"568","cpn17",2,0,0,2
"635","cpn18",1,1,0,0
"694","cpn19",4,0,0,4
"761","cpn20",2,1,0,1
"830","cpn21",1,0,0,1
"897","cpn22",40,14,1,26
"956","cpn23",11,2,0,9
"1018","cpn24",6,2,0,4
"1086","cpn25",3,0,0,3
"1140","cpn26",2,0,0,2
"1260","cpn28",20,13,2,7
"1302","cpn29",4,0,0,4
"1359","cpn30",2,1,0,1
"1450","cpn32",1,0,0,1
"1525","cpn34",1,0,0,1
"1535","cpn35",1,0,0,1
"1542","cpn36",9,4,0,5
"1551","cpn37",2,0,0,2
"1560","cpn38",12,1,0,11
"1570","cpn39",5,2,0,3
"1578","cpn40",10,3,0,7
"1587","cpn41",2,2,0,0
"1598","cpn42",6,0,0,6
"1606","cpn43",7,0,0,7
"1623","cpn45",9,2,0,7
"1633","cpn46",4,0,0,4
"1651","cpn48",7,3,0,4
"1659","cpn49",3,0,0,3
"1669","cpn50",2,0,0,2
"1680","cpn51",6,1,0,5
"1690","cpn52",5,2,0,3
"1699","cpn53",5,0,0,5
"1706","cpn54",8,0,0,8
"1717","cpn55",1,0,0,1
"1727","cpn56",3,1,0,2
"1738","cpn57",4,2,0,2
"1747","cpn58",2,0,0,2
"1756","cpn59",3,0,0,3
"1764","cpn60",8,1,0,7
"1781","cpn62",13,1,0,12
"1791","cpn63",8,1,0,7
"1800","cpn64",13,1,0,12
"1810","cpn65",8,0,0,8
"1821","cpn66",1,1,0,0
"1830","cpn67",6,2,0,4
"1839","cpn68",1,0,0,1
"1846","cpn69",5,1,0,4
"1853","cpn70",4,0,0,4
"1860","cpn71",17,0,0,17
"1869","cpn72",2,1,0,1
"1880","cpn73",1,0,0,1
"1890","cpn74",5,1,0,4
"1898","cpn75",3,2,0,1
"1905","cpn76",1,0,0,1
"1911","cpn77",1,0,0,1
"1916","cpn78",7,1,0,6
"1924","cpn79",4,1,0,3
"1933","cpn80",1,0,0,1
"1951","cpn82",6,2,0,4
"1961","cpn83",3,1,0,2
"1971","cpn84",1,0,0,1
"1978","cpn85",1,0,0,1
"2002","cpn88",14,3,0,11
"2012","cpn89",6,0,0,6
"2022","cpn90",16,3,0,13
"2032","cpn91",7,1,0,6
"2037","cpn92",2,0,0,2
"2052","cpn94",13,3,0,10
"2061","cpn95",12,3,0,9
"2072","cpn96",2,0,0,2
"2081","cpn97",13,1,0,12
"2088","cpn98",6,0,0,6
"2096","cpn99",2,1,0,1
"3","cpn100",2,1,0,1
"10","cpn101",1,0,0,1
"16","cpn102",2,0,0,2
"23","cpn103",2,0,0,2
"36","cpn105",7,2,1,5
"42","cpn106",2,0,0,2
"50","cpn107",2,0,0,2
"59","cpn108",9,8,0,1
"69","cpn109",1,0,0,1
"76","cpn110",3,0,0,3
"86","cpn111",4,0,0,4
"94","cpn112",4,0,0,4
"103","cpn113",1,0,0,1
"113","cpn114",12,10,0,2
"132","cpn116",4,0,0,4
"145","cpn118",1,0,0,1
"154","cpn119",11,4,0,7
"163","cpn120",9,0,0,9
"172","cpn121",6,0,0,6
"178","cpn122",1,0,0,1
"188","cpn123",1,0,0,1
"198","cpn124",3,1,0,2
"204","cpn125",10,2,0,8
"212","cpn126",4,0,0,4
"230","cpn128",7,3,0,4
"237","cpn129",5,1,0,4
"261","cpn132",2,1,0,1
"270","cpn133",1,1,0,0
"277","cpn134",2,2,0,0
"284","cpn135",2,1,0,1
"292","cpn136",3,0,0,3
"302","cpn137",1,0,0,1
"313","cpn138",8,3,0,5
"321","cpn139",5,0,0,5
"330","cpn140",4,0,0,4
"338","cpn141",2,1,0,1
"347","cpn142",10,0,0,10
"355","cpn143",2,0,0,2
"364","cpn144",5,1,0,4
"372","cpn145",1,0,0,1
"380","cpn146",4,1,0,3
"389","cpn147",1,0,0,1
"400","cpn148",3,1,0,2
"410","cpn149",6,1,0,5
"416","cpn150",5,1,0,4
"425","cpn151",5,1,1,4
"432","cpn152",3,1,0,2
"442","cpn153",6,2,0,4
"453","cpn154",9,2,0,7
"461","cpn155",8,1,0,7
"466","cpn156",17,4,0,13
"476","cpn157",6,0,0,6
"484","cpn158",9,1,0,8
"492","cpn159",17,0,0,17
"500","cpn160",4,2,0,2
"508","cpn161",31,7,0,24
"516","cpn162",11,5,0,6
"521","cpn163",1,1,0,0
"526","cpn164",1,1,0,0
"534","cpn165",37,7,0,30
"540","cpn166",17,0,0,17
"547","cpn167",9,1,0,8
"554","cpn168",2,1,0,1
"569","cpn170",1,1,0,0
"573","cpn171",2,0,0,2
"583","cpn172",6,3,0,3
"596","cpn174",4,1,0,3
"610","cpn176",7,1,0,6
"617","cpn177",2,1,0,1
"624","cpn178",2,0,0,2
"627","cpn179",1,0,0,1
"636","cpn180",7,1,0,6
"642","cpn181",10,0,0,10
"657","cpn184",8,3,0,5
"664","cpn185",7,2,0,5
"673","cpn187",6,0,0,6
"680","cpn188",3,1,0,2
"688","cpn189",1,0,0,1
"695","cpn190",3,1,0,2
"702","cpn191",1,0,0,1
"715","cpn193",18,0,0,18
"721","cpn194",4,1,0,3
"726","cpn195",1,0,0,1
"733","cpn196",4,0,0,4
"741","cpn197",6,2,0,4
"744","cpn198",4,0,0,4
"751","cpn199",1,0,0,1
"770","cpn201",1,0,0,1
"782","cpn203",11,5,0,6
"791","cpn204",14,1,0,13
"798","cpn205",4,0,0,4
"805","cpn206",2,2,0,0
"814","cpn207",3,1,0,2
"818","cpn208",4,1,0,3
"824","cpn209",3,0,0,3
"831","cpn210",2,0,0,2
"839","cpn211",3,0,0,3
"845","cpn212",5,0,0,5
"850","cpn213",1,0,0,1
"859","cpn215",3,1,0,2
"869","cpn216",4,0,0,4
"874","cpn217",1,1,0,0
"883","cpn218",3,2,0,1
"889","cpn219",5,0,0,5
"898","cpn220",1,0,0,1
"913","cpn222",1,1,1,0
"922","cpn224",1,0,0,1
"930","cpn225",1,0,0,1
"939","cpn226",1,0,0,1
"943","cpn227",7,2,0,5
"947","cpn228",2,0,0,2
"952","cpn229",1,0,0,1
"957","cpn230",6,0,0,6
"962","cpn231",6,1,0,5
"969","cpn232",1,0,0,1
"976","cpn233",2,0,0,2
"997","cpn236",1,0,0,1
"1000","cpn237",1,0,0,1
"1011","cpn239",3,1,0,2
"1019","cpn240",1,0,0,1
"1040","cpn243",1,0,0,1
"1045","cpn244",1,0,0,1
"1054","cpn245",2,1,0,1
"1061","cpn246",1,1,0,0
"1067","cpn247",1,1,0,0
"1073","cpn248",5,2,0,3
"1077","cpn249",3,2,0,1
"1087","cpn250",6,1,0,5
"1093","cpn251",2,1,0,1
"1095","cpn252",2,0,0,2
"1100","cpn253",1,0,0,1
"1104","cpn254",1,0,0,1
"1110","cpn255",5,3,1,2
"1117","cpn256",4,1,1,3
"1125","cpn257",2,0,0,2
"1134","cpn258",1,0,0,1
"1136","cpn259",5,2,0,3
"1141","cpn260",7,0,0,7
"1149","cpn261",7,0,0,7
"1154","cpn262",3,1,0,2
"1162","cpn263",7,2,0,5
"1168","cpn264",3,3,0,0
"1176","cpn265",1,0,0,1
"1181","cpn266",2,0,0,2
"1187","cpn267",6,0,0,6
"1193","cpn268",3,0,0,3
"1198","cpn269",6,3,0,3
"1204","cpn270",2,0,0,2
"1219","cpn272",10,3,0,7
"1227","cpn273",3,3,0,0
"1231","cpn274",1,1,0,0
"1234","cpn275",14,4,0,10
"1238","cpn276",4,0,0,4
"1246","cpn277",7,0,0,7
"1251","cpn278",1,0,0,1
"1255","cpn279",2,2,0,0
"1261","cpn280",1,0,0,1
"1266","cpn281",6,1,0,5
"1273","cpn283",27,10,0,17
"1278","cpn284",1,0,0,1
"1294","cpn288",8,3,0,5
"1298","cpn289",10,0,0,10
"1307","cpn291",1,0,0,1
"1313","cpn292",10,1,0,9
"1318","cpn293",2,0,0,2
"1328","cpn294",1,1,0,0
"1333","cpn295",1,0,0,1
"1341","cpn296",8,1,0,7
"1344","cpn297",1,1,0,0
"1349","cpn298",3,1,0,2
"1352","cpn299",1,1,0,0
"1360","cpn300",8,1,0,7
"1363","cpn301",6,2,0,4
"1365","cpn302",12,1,0,11
"1380","cpn305",3,1,0,2
"1384","cpn306",1,0,0,1
"1387","cpn307",2,1,0,1
"1393","cpn308",7,1,0,6
"1397","cpn309",1,0,0,1
"1402","cpn310",7,1,0,6
"1408","cpn311",3,1,0,2
"1412","cpn312",9,1,0,8
"1423","cpn314",1,0,0,1
"1441","cpn318",37,10,0,27
"1446","cpn319",7,0,0,7
"1451","cpn320",6,1,0,5
"1457","cpn321",1,1,0,0
"1462","cpn322",3,1,0,2
"1467","cpn323",1,0,0,1
"1473","cpn325",2,0,0,2
"1478","cpn326",5,0,0,5
"1484","cpn327",8,2,0,6
"1490","cpn328",3,0,0,3
"1494","cpn329",3,1,0,2
"1497","cpn330",3,1,0,2
"1501","cpn331",1,0,0,1
"1506","cpn332",1,1,0,0
"1521","cpn336",6,2,0,4
"1522","cpn337",4,3,0,1
"1523","cpn338",25,5,0,20
"1524","cpn339",5,2,0,3
"1526","cpn340",5,0,0,5
"1527","cpn341",9,2,0,7
"1528","cpn342",2,1,0,1
"1529","cpn343",3,0,0,3
"1530","cpn344",2,0,0,2
"1531","cpn345",1,0,0,1
"1532","cpn347",1,0,0,1
"1533","cpn348",4,0,0,4
"1534","cpn349",1,0,0,1
"1536","cpn351",2,0,0,2
"1537","cpn352",1,0,0,1
"1538","cpn355",6,3,0,3
"1539","cpn356",1,0,0,1
"1540","cpn357",4,0,0,4
"1541","cpn358",3,0,0,3
"1543","cpn361",3,2,0,1
"1544","cpn362",1,0,0,1
"1545","cpn363",1,0,0,1
"1546","cpn364",1,0,0,1
"1547","cpn365",2,0,0,2
"1548","cpn366",2,1,0,1
"1549","cpn368",2,0,0,2
"1550","cpn369",4,1,0,3
"1552","cpn370",2,2,0,0
"1553","cpn371",1,0,0,1
"1554","cpn372",2,0,0,2
"1555","cpn373",9,2,0,7
"1556","cpn374",1,0,0,1
"1557","cpn376",2,0,0,2
"1558","cpn378",16,0,0,16
"1559","cpn379",6,1,0,5
"1561","cpn380",1,0,0,1
"1562","cpn381",4,0,0,4
"1563","cpn382",1,0,0,1
"1564","cpn384",1,0,0,1
"1565","cpn385",2,0,0,2
"1566","cpn386",3,1,0,2
"1567","cpn387",23,5,0,18
"1568","cpn388",1,0,0,1
"1569","cpn389",3,1,0,2
"1571","cpn391",4,0,0,4
"1572","cpn392",1,0,0,1
"1573","cpn395",3,1,0,2
"1574","cpn396",5,0,0,5
"1575","cpn397",3,0,0,3
"1576","cpn398",3,1,0,2
"1577","cpn399",3,0,0,3
"1579","cpn402",2,0,0,2
"1580","cpn403",1,1,0,0
"1581","cpn404",2,0,0,2
"1582","cpn405",2,1,0,1
"1583","cpn406",4,0,0,4
"1584","cpn407",1,1,0,0
"1585","cpn408",5,3,0,2
"1586","cpn409",4,1,0,3
"1588","cpn410",1,0,0,1
"1589","cpn411",1,0,0,1
"1590","cpn412",8,1,0,7
"1591","cpn413",4,0,0,4
"1592","cpn414",1,0,0,1
"1593","cpn415",6,0,0,6
"1594","cpn416",2,1,0,1
"1595","cpn417",2,1,0,1
"1596","cpn418",9,1,0,8
"1597","cpn419",6,1,0,5
"1599","cpn422",3,0,0,3
"1600","cpn423",1,1,0,0
"1601","cpn425",3,0,0,3
"1602","cpn426",28,3,0,25
"1603","cpn427",1,0,0,1
"1604","cpn428",2,1,0,1
"1605","cpn429",2,1,0,1
"1607","cpn430",6,1,0,5
"1608","cpn431",6,2,0,4
"1609","cpn432",3,0,0,3
"1610","cpn434",4,2,0,2
"1611","cpn435",1,0,0,1
"1612","cpn436",2,0,0,2
"1613","cpn437",2,0,0,2
"1614","cpn439",1,0,0,1
"1615","cpn440",5,0,0,5
"1616","cpn441",10,1,0,9
"1617","cpn444",4,1,0,3
"1618","cpn445",2,0,0,2
"1619","cpn446",1,0,0,1
"1620","cpn447",5,0,0,5
"1621","cpn448",10,1,0,9
"1622","cpn449",5,0,0,5
"1624","cpn450",2,0,0,2
"1625","cpn451",6,1,0,5
"1626","cpn452",3,1,0,2
"1627","cpn453",7,2,0,5
"1628","cpn454",3,2,0,1
"1629","cpn455",5,0,0,5
"1630","cpn457",4,1,0,3
"1631","cpn458",1,0,0,1
"1632","cpn459",4,1,0,3
"1634","cpn460",2,1,0,1
"1635","cpn461",4,1,0,3
"1636","cpn462",3,0,0,3
"1637","cpn463",5,0,0,5
"1638","cpn464",5,2,0,3
"1639","cpn465",2,0,0,2
"1640","cpn466",3,1,0,2
"1641","cpn467",7,1,0,6
"1642","cpn468",2,1,0,1
"1643","cpn470",1,0,0,1
"1644","cpn471",5,0,0,5
"1645","cpn472",2,2,0,0
"1646","cpn473",6,1,0,5
"1647","cpn474",2,0,0,2
"1648","cpn475",1,0,0,1
"1649","cpn476",2,0,0,2
"1650","cpn479",1,1,1,0
"1652","cpn480",1,0,0,1
"1653","cpn482",1,1,0,0
"1654","cpn483",3,2,0,1
"1655","cpn486",6,0,0,6
"1656","cpn487",3,0,0,3
"1657","cpn488",1,0,0,1
"1658","cpn489",1,0,0,1
"1660","cpn490",4,1,0,3
"1661","cpn492",1,0,0,1
"1662","cpn493",4,0,0,4
"1663","cpn494",15,4,0,11
"1664","cpn495",3,0,0,3
"1665","cpn496",3,0,0,3
"1666","cpn497",3,0,0,3
"1667","cpn498",1,0,0,1
"1668","cpn499",8,3,0,5
"1670","cpn500",1,0,0,1
"1671","cpn501",4,2,0,2
"1672","cpn502",3,0,0,3
"1673","cpn503",1,0,0,1
"1674","cpn504",12,3,0,9
"1675","cpn505",7,1,0,6
"1676","cpn506",3,1,0,2
"1677","cpn507",2,0,0,2
"1678","cpn508",1,0,0,1
"1679","cpn509",2,0,0,2
"1681","cpn510",1,0,0,1
"1682","cpn511",2,1,0,1
"1683","cpn512",12,2,0,10
"1684","cpn513",7,4,0,3
"1685","cpn514",4,1,0,3
"1686","cpn515",9,0,0,9
"1687","cpn516",2,2,0,0
"1688","cpn518",10,0,0,10
"1689","cpn519",2,1,0,1
"1691","cpn521",1,0,0,1
"1692","cpn522",8,0,0,8
"1693","cpn523",1,1,0,0
"1694","cpn525",2,0,0,2
"1695","cpn526",1,0,0,1
"1696","cpn527",6,0,0,6
"1697","cpn528",5,1,0,4
"1698","cpn529",2,1,0,1
"1700","cpn530",10,0,0,10
"1701","cpn531",2,0,0,2
"1702","cpn532",5,0,0,5
"1703","cpn533",7,1,0,6
"1704","cpn534",4,2,0,2
"1705","cpn535",1,1,0,0
"1707","cpn540",4,1,0,3
"1708","cpn541",2,1,0,1
"1709","cpn542",6,1,0,5
"1710","cpn543",4,1,0,3
"1711","cpn544",2,0,0,2
"1712","cpn545",5,0,0,5
"1713","cpn546",2,1,0,1
"1714","cpn547",2,1,0,1
"1715","cpn548",1,0,0,1
"1716","cpn549",2,0,0,2
"1718","cpn550",3,1,0,2
"1719","cpn551",1,0,0,1
"1720","cpn552",2,1,0,1
"1721","cpn553",1,1,0,0
"1722","cpn554",1,0,0,1
"1723","cpn555",7,1,0,6
"1724","cpn556",5,0,0,5
"1725","cpn557",5,2,0,3
"1726","cpn558",9,2,0,7
"1728","cpn560",11,1,0,10
"1729","cpn561",7,1,0,6
"1730","cpn562",4,1,0,3
"1731","cpn563",3,1,0,2
"1732","cpn564",2,0,0,2
"1733","cpn565",1,1,0,0
"1734","cpn566",15,2,0,13
"1735","cpn567",10,3,0,7
"1736","cpn568",6,2,0,4
"1737","cpn569",1,0,0,1
"1739","cpn570",6,2,0,4
"1740","cpn571",4,1,0,3
"1741","cpn572",7,1,0,6
"1742","cpn574",5,0,0,5
"1743","cpn575",4,2,0,2
"1744","cpn576",7,1,0,6
"1745","cpn577",1,0,0,1
"1746","cpn578",1,0,0,1
"1748","cpn581",1,1,0,0
"1749","cpn582",2,2,0,0
"1750","cpn583",2,0,0,2
"1751","cpn584",7,0,0,7
"1752","cpn585",4,0,0,4
"1753","cpn586",7,2,0,5
"1754","cpn587",1,0,0,1
"1755","cpn589",2,0,0,2
"1757","cpn590",1,0,0,1
"1758","cpn592",7,2,0,5
"1759","cpn593",6,1,0,5
"1760","cpn596",1,0,0,1
"1761","cpn597",2,0,0,2
"1762","cpn598",4,1,0,3
"1763","cpn599",1,1,0,0
"1765","cpn600",1,0,0,1
"1766","cpn601",2,0,0,2
"1767","cpn602",1,1,0,0
"1768","cpn603",1,0,0,1
"1769","cpn604",14,2,0,12
"1770","cpn606",1,1,0,0
"1771","cpn608",8,1,0,7
"1772","cpn609",3,2,0,1
"1773","cpn610",4,1,0,3
"1774","cpn611",3,0,0,3
"1775","cpn612",2,0,0,2
"1776","cpn613",2,0,0,2
"1777","cpn615",5,1,0,4
"1778","cpn616",1,0,0,1
"1779","cpn618",6,1,0,5
"1780","cpn619",10,1,0,9
"1782","cpn620",3,0,0,3
"1783","cpn622",3,0,0,3
"1784","cpn623",1,0,0,1
"1785","cpn624",11,2,0,9
"1786","cpn625",4,1,0,3
"1787","cpn626",4,0,0,4
"1788","cpn627",1,0,0,1
"1789","cpn628",2,1,0,1
"1790","cpn629",1,0,0,1
"1792","cpn630",3,0,0,3
"1793","cpn633",8,1,0,7
"1794","cpn634",1,0,0,1
"1795","cpn635",6,0,0,6
"1796","cpn636",4,0,0,4
"1797","cpn637",4,0,0,4
"1798","cpn638",1,0,0,1
"1799","cpn639",1,0,0,1
"1801","cpn640",5,0,0,5
"1802","cpn641",4,1,0,3
"1803","cpn642",1,0,0,1
"1804","cpn643",1,0,0,1
"1805","cpn644",1,1,0,0
"1806","cpn645",3,0,0,3
"1807","cpn646",1,0,0,1
"1808","cpn647",1,0,0,1
"1809","cpn649",1,0,0,1
"1811","cpn650",5,1,0,4
"1812","cpn651",3,1,0,2
"1813","cpn652",7,7,0,0
"1814","cpn653",1,0,0,1
"1815","cpn654",3,0,0,3
"1816","cpn655",8,4,0,4
"1817","cpn656",7,1,0,6
"1818","cpn657",1,0,0,1
"1819","cpn658",1,1,0,0
"1820","cpn659",2,0,0,2
"1822","cpn660",1,1,1,0
"1823","cpn662",4,3,0,1
"1824","cpn664",4,0,0,4
"1825","cpn665",8,2,0,6
"1826","cpn666",4,1,0,3
"1827","cpn667",7,2,0,5
"1828","cpn668",5,1,0,4
"1829","cpn669",2,0,0,2
"1831","cpn670",1,0,0,1
"1832","cpn671",3,0,0,3
"1833","cpn672",5,1,0,4
"1834","cpn674",5,0,0,5
"1835","cpn675",17,4,0,13
"1836","cpn676",3,0,0,3
"1837","cpn677",4,1,0,3
"1838","cpn678",19,3,0,16
"1840","cpn681",8,1,0,7
"1841","cpn682",3,1,0,2
"1842","cpn683",5,1,0,4
"1843","cpn685",2,0,0,2
"1844","cpn687",2,0,0,2
"1845","cpn688",4,2,0,2
"1847","cpn690",1,0,0,1
"1848","cpn694",8,2,0,6
"1849","cpn696",1,0,0,1
"1850","cpn698",2,0,0,2
"1851","cpn699",11,1,0,10
"1854","cpn701",2,1,0,1
"1855","cpn702",1,0,0,1
"1856","cpn703",2,0,0,2
"1857","cpn704",1,0,0,1
"1858","cpn705",5,1,0,4
"1859","cpn708",1,1,0,0
"1861","cpn710",2,1,0,1
"1862","cpn711",1,0,0,1
"1863","cpn713",2,1,0,1
"1864","cpn715",1,0,0,1
"1865","cpn716",2,0,0,2
"1866","cpn717",1,1,0,0
"1867","cpn718",2,0,0,2
"1868","cpn719",2,2,0,0
"1870","cpn720",1,0,0,1
"1871","cpn721",2,0,0,2
"1872","cpn722",11,3,0,8
"1873","cpn723",4,1,0,3
"1874","cpn724",2,0,0,2
"1875","cpn725",2,0,0,2
"1876","cpn726",8,3,0,5
"1877","cpn727",5,1,0,4
"1878","cpn728",1,0,0,1
"1879","cpn729",8,0,0,8
"1881","cpn730",5,1,0,4
"1882","cpn731",2,0,0,2
"1883","cpn733",6,6,1,0
"1884","cpn734",1,0,0,1
"1885","cpn735",2,2,0,0
"1886","cpn736",5,3,0,2
"1887","cpn737",2,1,0,1
"1888","cpn738",10,1,0,9
"1889","cpn739",4,2,0,2
"1891","cpn740",5,1,0,4
"1892","cpn741",1,0,0,1
"1893","cpn742",2,0,0,2
"1894","cpn743",2,0,0,2
"1895","cpn744",2,0,0,2
"1896","cpn745",8,2,0,6
"1897","cpn748",3,1,0,2
"1899","cpn750",1,0,0,1
"1900","cpn751",7,4,1,3
"1901","cpn754",1,0,0,1
"1902","cpn755",3,1,0,2
"1903","cpn757",1,0,0,1
"1904","cpn759",7,0,0,7
"1906","cpn760",3,0,0,3
"1907","cpn762",2,0,0,2
"1908","cpn763",2,0,0,2
"1909","cpn765",1,0,0,1
"1910","cpn769",2,1,0,1
"1912","cpn770",7,2,0,5
"1913","cpn777",1,0,0,1
"1914","cpn778",4,0,0,4
"1915","cpn779",2,1,0,1
"1917","cpn780",6,1,0,5
"1918","cpn782",9,0,0,9
"1919","cpn783",1,0,0,1
"1920","cpn784",3,0,0,3
"1921","cpn787",1,0,0,1
"1922","cpn788",3,0,0,3
"1923","cpn789",4,1,0,3
"1925","cpn791",2,0,0,2
"1926","cpn792",2,0,0,2
"1927","cpn793",1,0,0,1
"1928","cpn794",2,0,0,2
"1929","cpn797",1,0,0,1
"1930","cpn798",2,1,0,1
"1931","cpn799",2,1,0,1
"1934","cpn800",1,0,0,1
"1935","cpn801",10,5,0,5
"1936","cpn802",9,0,0,9
"1937","cpn803",5,1,0,4
"1938","cpn805",5,2,0,3
"1939","cpn807",4,0,0,4
"1940","cpn808",1,0,0,1
"1941","cpn809",4,1,0,3
"1942","cpn810",1,1,0,0
"1943","cpn811",3,1,0,2
"1944","cpn812",8,0,0,8
"1945","cpn813",5,1,0,4
"1946","cpn814",18,1,0,17
"1947","cpn816",1,1,0,0
"1948","cpn817",4,1,0,3
"1949","cpn818",2,0,0,2
"1950","cpn819",1,0,0,1
"1952","cpn820",1,0,0,1
"1953","cpn821",2,1,0,1
"1954","cpn823",7,0,0,7
"1955","cpn824",11,3,0,8
"1956","cpn825",7,1,0,6
"1957","cpn826",3,1,0,2
"1958","cpn827",5,1,0,4
"1959","cpn828",3,0,0,3
"1960","cpn829",4,1,0,3
"1962","cpn830",6,1,0,5
"1963","cpn831",5,1,0,4
"1964","cpn832",1,0,0,1
"1965","cpn833",2,2,0,0
"1966","cpn834",1,1,0,0
"1967","cpn835",1,0,0,1
"1968","cpn836",4,0,0,4
"1969","cpn838",1,0,0,1
"1970","cpn839",1,0,0,1
"1972","cpn840",1,0,0,1
"1973","cpn842",3,1,0,2
"1974","cpn843",3,1,0,2
"1975","cpn844",3,1,0,2
"1976","cpn847",5,1,0,4
"1977","cpn849",1,0,0,1
"1979","cpn850",1,0,0,1
"1980","cpn851",1,0,0,1
"1981","cpn852",4,2,0,2
"1982","cpn853",2,1,0,1
"1983","cpn855",1,1,0,0
"1984","cpn856",3,0,0,3
"1985","cpn857",5,3,0,2
"1986","cpn860",1,1,0,0
"1987","cpn862",2,0,0,2
"1988","cpn863",1,0,0,1
"1989","cpn864",2,0,0,2
"1990","cpn865",1,0,0,1
"1991","cpn868",1,0,0,1
"1992","cpn869",2,0,0,2
"1993","cpn870",1,0,0,1
"1994","cpn872",2,1,0,1
"1995","cpn873",1,0,0,1
"1996","cpn874",2,0,0,2
"1997","cpn875",1,0,0,1
"1998","cpn876",7,2,1,5
"1999","cpn877",1,0,0,1
"2000","cpn878",1,0,0,1
"2001","cpn879",3,1,0,2
"2003","cpn880",2,2,0,0
"2004","cpn881",1,0,0,1
"2005","cpn883",1,0,0,1
"2006","cpn884",1,0,0,1
"2007","cpn885",2,1,0,1
"2008","cpn886",2,0,0,2
"2009","cpn887",1,0,0,1
"2010","cpn888",2,2,0,0
"2011","cpn889",1,0,0,1
"2013","cpn890",8,3,0,5
"2014","cpn891",2,0,0,2
"2015","cpn892",2,0,0,2
"2016","cpn893",1,0,0,1
"2017","cpn895",3,2,0,1
"2018","cpn896",2,0,0,2
"2019","cpn898",12,1,0,11
"2020","cpn899",2,2,0,0
"2023","cpn900",2,1,0,1
"2024","cpn901",2,0,0,2
"2025","cpn902",2,0,0,2
"2026","cpn903",1,0,0,1
"2027","cpn904",1,0,0,1
"2028","cpn905",2,0,0,2
"2029","cpn906",1,0,0,1
"2030","cpn907",2,0,0,2
"2031","cpn909",1,0,0,1
"2033","cpn910",1,0,0,1
"2034","cpn915",2,0,0,2
"2035","cpn916",2,0,0,2
"2036","cpn917",4,1,0,3
"2038","cpn920",14,2,0,12
"2039","cpn921",1,1,0,0
"2040","cpn923",3,0,0,3
"2041","cpn924",3,0,0,3
"2042","cpn925",1,0,0,1
"2043","cpn926",5,2,0,3
"2044","cpn930",1,1,0,0
"2045","cpn931",1,1,0,0
"2046","cpn934",2,2,0,0
"2047","cpn935",1,0,0,1
"2048","cpn936",2,0,0,2
"2049","cpn937",8,2,0,6
"2050","cpn938",2,0,0,2
"2051","cpn939",2,0,0,2
"2053","cpn941",1,1,0,0
"2054","cpn942",1,1,0,0
"2055","cpn943",4,0,0,4
"2056","cpn944",1,0,0,1
"2057","cpn945",1,0,0,1
"2058","cpn946",4,0,0,4
"2059","cpn948",2,1,0,1
"2060","cpn949",6,2,0,4
"2062","cpn950",5,1,0,4
"2063","cpn951",14,5,0,9
"2064","cpn952",3,0,0,3
"2065","cpn953",1,0,0,1
"2066","cpn954",2,0,0,2
"2067","cpn955",8,2,0,6
"2068","cpn956",2,0,0,2
"2069","cpn957",1,0,0,1
"2070","cpn958",3,0,0,3
"2071","cpn959",4,1,0,3
"2073","cpn960",15,3,0,12
"2074","cpn961",2,1,0,1
"2075","cpn962",1,0,0,1
"2076","cpn963",2,0,0,2
"2077","cpn965",1,1,0,0
"2078","cpn966",9,2,0,7
"2079","cpn968",1,0,0,1
"2080","cpn969",1,0,0,1
"2082","cpn970",4,0,0,4
"2083","cpn971",2,1,0,1
"2084","cpn974",6,1,0,5
"2085","cpn975",3,0,0,3
"2086","cpn976",3,3,0,0
"2087","cpn979",2,0,0,2
"2089","cpn980",1,1,0,0
"2090","cpn982",1,0,0,1
"2091","cpn983",1,0,0,1
"2092","cpn985",1,0,0,1
"2093","cpn986",1,0,0,1
"2094","cpn987",3,1,0,2
"2095","cpn989",3,1,0,2
"2097","cpn990",2,0,0,2
"2098","cpn991",6,0,0,6
"2099","cpn992",3,1,0,2
"2100","cpn993",1,1,0,0
"2101","cpn996",4,0,0,4
"2102","cpn997",5,4,0,1
"2103","cpn998",5,0,0,5
"4","cpn1000",10,2,0,8
"5","cpn1001",1,0,0,1
"6","cpn1002",5,1,0,4
"7","cpn1003",1,0,0,1
"8","cpn1004",1,0,0,1
"9","cpn1007",4,1,0,3
"11","cpn1011",1,0,0,1
"12","cpn1015",12,6,0,6
"13","cpn1017",1,0,0,1
"14","cpn1018",1,1,0,0
"15","cpn1019",2,0,0,2
"17","cpn1020",1,0,0,1
"18","cpn1024",3,2,0,1
"19","cpn1026",1,0,0,1
"20","cpn1027",1,0,0,1
"21","cpn1028",2,0,0,2
"22","cpn1029",1,0,0,1
"24","cpn1030",1,0,0,1
"25","cpn1031",2,0,0,2
"26","cpn1033",1,0,0,1
"27","cpn1034",2,0,0,2
"28","cpn1035",2,1,0,1
"29","cpn1036",1,0,0,1
"30","cpn1038",2,2,0,0
"31","cpn1039",3,0,0,3
"32","cpn1040",1,1,0,0
"33","cpn1047",3,1,0,2
"34","cpn1048",1,0,0,1
"35","cpn1049",3,1,0,2
"37","cpn1050",3,0,0,3
"38","cpn1051",2,0,0,2
"39","cpn1052",1,0,0,1
"40","cpn1055",1,0,0,1
"41","cpn1056",2,1,0,1
"43","cpn1061",9,3,0,6
"44","cpn1062",2,0,0,2
"45","cpn1063",4,0,0,4
"46","cpn1064",2,0,0,2
"47","cpn1065",1,0,0,1
"48","cpn1068",1,0,0,1
"49","cpn1069",1,0,0,1
"51","cpn1072",8,1,0,7
"52","cpn1073",1,0,0,1
"53","cpn1074",1,0,0,1
"54","cpn1075",3,0,0,3
"55","cpn1076",2,1,0,1
"56","cpn1077",1,0,0,1
"57","cpn1078",1,0,0,1
"58","cpn1079",2,0,0,2
"60","cpn1080",3,1,0,2
"61","cpn1081",1,0,0,1
"62","cpn1082",7,1,0,6
"63","cpn1083",1,0,0,1
"64","cpn1085",6,2,0,4
"65","cpn1086",1,0,0,1
"66","cpn1087",1,1,0,0
"67","cpn1088",4,0,0,4
"68","cpn1089",1,1,0,0
"70","cpn1093",2,0,0,2
"71","cpn1094",1,0,0,1
"72","cpn1095",2,0,0,2
"73","cpn1097",3,0,0,3
"74","cpn1099",1,0,0,1
"77","cpn1101",3,0,0,3
"78","cpn1102",1,0,0,1
"79","cpn1103",3,1,0,2
"80","cpn1104",1,0,0,1
"81","cpn1105",3,0,0,3
"82","cpn1106",1,0,0,1
"83","cpn1107",3,0,0,3
"84","cpn1108",2,1,0,1
"85","cpn1109",2,1,0,1
"87","cpn1110",5,1,0,4
"88","cpn1111",3,1,0,2
"89","cpn1113",3,0,0,3
"90","cpn1114",3,0,0,3
"91","cpn1115",6,0,0,6
"92","cpn1118",1,0,0,1
"93","cpn1119",6,2,0,4
"95","cpn1120",2,0,0,2
"96","cpn1123",4,0,0,4
"97","cpn1124",13,1,0,12
"98","cpn1125",4,0,0,4
"99","cpn1126",1,0,0,1
"100","cpn1127",1,0,0,1
"101","cpn1128",4,0,0,4
"102","cpn1129",1,0,0,1
"104","cpn1131",1,0,0,1
"105","cpn1132",1,0,0,1
"106","cpn1133",1,0,0,1
"107","cpn1134",2,1,0,1
"108","cpn1135",1,0,0,1
"109","cpn1136",2,0,0,2
"110","cpn1137",8,2,0,6
"111","cpn1138",1,0,0,1
"112","cpn1139",2,0,0,2
"114","cpn1140",2,1,0,1
"115","cpn1141",4,2,0,2
"116","cpn1142",2,0,0,2
"117","cpn1143",2,1,0,1
"118","cpn1144",1,0,0,1
"119","cpn1145",1,0,0,1
"120","cpn1146",2,0,0,2
"121","cpn1147",1,0,0,1
"122","cpn1148",3,0,0,3
"123","cpn1149",1,0,0,1
"124","cpn1150",1,1,0,0
"125","cpn1151",1,1,0,0
"126","cpn1154",1,1,0,0
"127","cpn1155",1,1,0,0
"128","cpn1156",3,0,0,3
"129","cpn1157",6,3,0,3
"130","cpn1158",4,0,0,4
"131","cpn1159",3,0,0,3
"133","cpn1160",5,3,0,2
"134","cpn1161",2,0,0,2
"135","cpn1162",1,0,0,1
"136","cpn1163",1,0,0,1
"137","cpn1164",1,0,0,1
"138","cpn1165",1,1,0,0
"139","cpn1170",2,0,0,2
"140","cpn1171",1,0,0,1
"141","cpn1174",4,0,0,4
"142","cpn1175",2,0,0,2
"143","cpn1176",1,1,0,0
"144","cpn1178",1,0,0,1
"146","cpn1180",1,0,0,1
"147","cpn1181",3,0,0,3
"148","cpn1182",4,0,0,4
"149","cpn1183",4,1,0,3
"150","cpn1184",1,1,0,0
"151","cpn1186",2,0,0,2
"152","cpn1187",2,0,0,2
"153","cpn1188",1,0,0,1
"155","cpn1190",2,1,0,1
"156","cpn1191",2,0,0,2
"157","cpn1192",1,0,0,1
"158","cpn1193",2,0,0,2
"159","cpn1194",1,1,0,0
"160","cpn1197",3,3,0,0
"161","cpn1199",1,0,0,1
"164","cpn1201",10,2,0,8
"165","cpn1202",2,1,0,1
"166","cpn1203",2,0,0,2
"167","cpn1204",5,0,0,5
"168","cpn1205",1,1,0,0
"169","cpn1206",2,1,0,1
"170","cpn1207",4,1,0,3
"171","cpn1209",1,0,0,1
"173","cpn1212",1,0,0,1
"174","cpn1213",1,0,0,1
"175","cpn1216",1,0,0,1
"176","cpn1217",2,0,0,2
"177","cpn1218",2,0,0,2
"179","cpn1220",2,1,0,1
"180","cpn1221",1,1,0,0
"181","cpn1222",4,0,0,4
"182","cpn1224",1,0,0,1
"183","cpn1225",3,1,0,2
"184","cpn1226",1,0,0,1
"185","cpn1227",3,1,0,2
"186","cpn1228",2,0,0,2
"187","cpn1229",2,2,0,0
"189","cpn1230",3,1,0,2
"190","cpn1231",1,1,0,0
"191","cpn1232",2,0,0,2
"192","cpn1234",4,0,0,4
"193","cpn1235",1,0,0,1
"194","cpn1236",2,0,0,2
"195","cpn1237",3,1,0,2
"196","cpn1238",1,0,0,1
"197","cpn1239",1,0,0,1
"199","cpn1240",5,0,0,5
"200","cpn1241",2,0,0,2
"201","cpn1242",3,0,0,3
"202","cpn1243",1,0,0,1
"203","cpn1249",6,0,0,6
"205","cpn1250",1,0,0,1
"206","cpn1251",5,0,0,5
"207","cpn1253",1,0,0,1
"208","cpn1254",1,0,0,1
"209","cpn1255",5,1,0,4
"210","cpn1258",1,0,0,1
"211","cpn1259",1,1,0,0
"213","cpn1260",1,0,0,1
"214","cpn1261",1,0,0,1
"215","cpn1262",1,0,0,1
"216","cpn1263",4,3,0,1
"217","cpn1264",4,0,0,4
"218","cpn1265",1,0,0,1
"219","cpn1266",1,0,0,1
"220","cpn1268",1,1,0,0
"221","cpn1269",2,1,0,1
"222","cpn1270",9,3,0,6
"223","cpn1271",1,0,0,1
"224","cpn1272",1,0,0,1
"225","cpn1273",2,2,0,0
"226","cpn1274",1,0,0,1
"227","cpn1275",3,0,0,3
"228","cpn1276",1,0,0,1
"229","cpn1277",2,2,0,0
"231","cpn1281",2,0,0,2
"232","cpn1282",1,0,0,1
"233","cpn1283",1,0,0,1
"234","cpn1284",1,0,0,1
"235","cpn1288",3,0,0,3
"236","cpn1289",1,0,0,1
"238","cpn1290",3,0,0,3
"239","cpn1291",7,0,0,7
"240","cpn1292",2,0,0,2
"241","cpn1293",2,0,0,2
"242","cpn1294",3,0,0,3
"243","cpn1295",1,1,0,0
"244","cpn1296",1,1,0,0
"245","cpn1298",2,0,0,2
"246","cpn1299",1,0,0,1
"248","cpn1300",1,0,0,1
"249","cpn1301",1,1,0,0
"250","cpn1304",2,0,0,2
"251","cpn1305",2,0,0,2
"252","cpn1306",1,0,0,1
"253","cpn1308",3,0,0,3
"254","cpn1309",1,0,0,1
"255","cpn1310",2,0,0,2
"256","cpn1311",1,1,0,0
"257","cpn1312",3,1,0,2
"258","cpn1314",6,0,0,6
"259","cpn1315",2,0,0,2
"260","cpn1317",3,0,0,3
"262","cpn1320",2,0,0,2
"263","cpn1321",1,0,0,1
"264","cpn1322",3,0,0,3
"265","cpn1323",1,0,0,1
"266","cpn1325",1,0,0,1
"267","cpn1326",1,0,0,1
"268","cpn1328",4,1,0,3
"269","cpn1329",5,1,0,4
"271","cpn1331",5,0,0,5
"272","cpn1332",1,0,0,1
"273","cpn1334",2,0,0,2
"274","cpn1335",2,0,0,2
"275","cpn1337",5,1,0,4
"276","cpn1338",2,1,0,1
"278","cpn1341",1,0,0,1
"279","cpn1342",2,0,0,2
"280","cpn1344",2,0,0,2
"281","cpn1346",1,1,0,0
"282","cpn1347",2,0,0,2
"283","cpn1349",1,0,0,1
"285","cpn1350",1,0,0,1
"286","cpn1351",2,0,0,2
"287","cpn1354",3,2,0,1
"288","cpn1355",4,0,0,4
"289","cpn1356",1,0,0,1
"290","cpn1358",3,0,0,3
"291","cpn1359",1,0,0,1
"293","cpn1360",1,0,0,1
"294","cpn1361",1,0,0,1
"295","cpn1362",1,0,0,1
"296","cpn1363",1,0,0,1
"297","cpn1364",3,0,0,3
"298","cpn1366",4,0,0,4
"299","cpn1367",3,2,0,1
"300","cpn1368",3,0,0,3
"301","cpn1369",2,0,0,2
"303","cpn1370",3,1,0,2
"304","cpn1371",1,0,0,1
"305","cpn1372",1,0,0,1
"306","cpn1373",1,0,0,1
"307","cpn1374",4,2,0,2
"308","cpn1375",1,0,0,1
"309","cpn1376",2,0,0,2
"310","cpn1377",4,0,0,4
"311","cpn1378",2,1,0,1
"312","cpn1379",1,0,0,1
"314","cpn1381",2,0,0,2
"315","cpn1382",5,2,0,3
"316","cpn1384",2,0,0,2
"317","cpn1385",1,0,0,1
"318","cpn1387",3,0,0,3
"319","cpn1388",1,0,0,1
"320","cpn1389",3,0,0,3
"322","cpn1390",2,2,0,0
"323","cpn1391",1,0,0,1
"324","cpn1394",7,1,0,6
"325","cpn1395",6,0,0,6
"326","cpn1397",2,1,0,1
"327","cpn1398",2,0,0,2
"328","cpn1399",1,0,0,1
"331","cpn1400",4,2,0,2
"332","cpn1401",2,1,0,1
"333","cpn1404",1,1,0,0
"334","cpn1405",1,0,0,1
"335","cpn1406",3,0,0,3
"336","cpn1407",2,0,0,2
"337","cpn1408",2,0,0,2
"339","cpn1410",1,0,0,1
"340","cpn1411",4,1,0,3
"341","cpn1412",1,0,0,1
"342","cpn1414",2,1,0,1
"343","cpn1415",1,0,0,1
"344","cpn1416",3,1,0,2
"345","cpn1417",1,0,0,1
"346","cpn1419",1,0,0,1
"348","cpn1420",5,1,0,4
"349","cpn1421",2,0,0,2
"350","cpn1422",2,0,0,2
"351","cpn1424",1,0,0,1
"352","cpn1425",2,0,0,2
"353","cpn1428",1,0,0,1
"354","cpn1429",3,0,0,3
"356","cpn1430",1,1,0,0
"357","cpn1431",1,0,0,1
"358","cpn1432",4,0,0,4
"359","cpn1433",2,0,0,2
"360","cpn1436",1,1,0,0
"361","cpn1437",5,1,0,4
"362","cpn1438",1,0,0,1
"363","cpn1439",1,0,0,1
"365","cpn1440",1,0,0,1
"366","cpn1441",1,1,0,0
"367","cpn1442",1,0,0,1
"368","cpn1443",1,0,0,1
"369","cpn1444",2,0,0,2
"370","cpn1446",2,1,0,1
"371","cpn1448",2,0,0,2
"373","cpn1451",5,1,0,4
"374","cpn1452",3,0,0,3
"375","cpn1454",2,0,0,2
"376","cpn1455",2,0,0,2
"377","cpn1457",3,2,0,1
"378","cpn1458",1,0,0,1
"379","cpn1459",3,1,0,2
"381","cpn1460",1,0,0,1
"382","cpn1461",1,0,0,1
"383","cpn1462",2,0,0,2
"384","cpn1464",1,0,0,1
"385","cpn1466",2,2,0,0
"386","cpn1467",2,0,0,2
"387","cpn1468",2,0,0,2
"388","cpn1469",3,1,0,2
"390","cpn1470",2,0,0,2
"391","cpn1471",3,0,0,3
"392","cpn1472",2,2,0,0
"393","cpn1473",2,0,0,2
"394","cpn1474",2,0,0,2
"395","cpn1475",1,0,0,1
"396","cpn1476",2,0,0,2
"397","cpn1477",1,0,0,1
"398","cpn1478",2,0,0,2
"399","cpn1479",4,0,0,4
"401","cpn1480",1,0,0,1
"402","cpn1481",7,2,0,5
"403","cpn1483",1,0,0,1
"404","cpn1484",3,0,0,3
"405","cpn1485",1,0,0,1
"406","cpn1486",3,2,0,1
"407","cpn1487",2,0,0,2
"408","cpn1488",4,1,0,3
"409","cpn1489",1,0,0,1
"411","cpn1490",2,0,0,2
"412","cpn1492",1,0,0,1
"413","cpn1495",2,0,0,2
"414","cpn1497",1,1,0,0
"417","cpn1500",2,0,0,2
"418","cpn1501",4,1,0,3
"419","cpn1503",1,0,0,1
"420","cpn1504",1,0,0,1
"421","cpn1505",2,1,0,1
"422","cpn1507",1,0,0,1
"423","cpn1508",3,1,0,2
"424","cpn1509",1,0,0,1
"426","cpn1514",6,0,0,6
"427","cpn1515",3,1,0,2
"428","cpn1516",1,1,0,0
"429","cpn1517",1,0,0,1
"430","cpn1518",3,1,0,2
"431","cpn1519",2,0,0,2
"433","cpn1520",2,0,0,2
"434","cpn1521",1,1,0,0
"435","cpn1522",2,1,0,1
"436","cpn1523",2,0,0,2
"437","cpn1524",2,0,0,2
"438","cpn1525",2,0,0,2
"439","cpn1526",1,0,0,1
"440","cpn1528",3,0,0,3
"441","cpn1529",1,0,0,1
"443","cpn1530",2,0,0,2
"444","cpn1531",2,0,0,2
"445","cpn1532",2,0,0,2
"446","cpn1533",1,0,0,1
"447","cpn1534",1,1,0,0
"448","cpn1535",3,1,0,2
"449","cpn1536",2,0,0,2
"450","cpn1537",1,0,0,1
"451","cpn1538",1,0,0,1
"452","cpn1539",1,0,0,1
"454","cpn1540",2,1,0,1
"455","cpn1542",1,0,0,1
"456","cpn1545",1,1,0,0
"457","cpn1546",2,0,0,2
"458","cpn1547",1,0,0,1
"459","cpn1548",1,0,0,1
"460","cpn1549",1,1,0,0
"462","cpn1550",4,0,0,4
"463","cpn1554",1,0,0,1
"464","cpn1558",3,0,0,3
"465","cpn1559",4,0,0,4
"467","cpn1560",3,0,0,3
"468","cpn1561",4,2,0,2
"469","cpn1562",1,0,0,1
"470","cpn1563",1,1,0,0
"471","cpn1564",1,0,0,1
"472","cpn1565",2,0,0,2
"473","cpn1566",2,0,0,2
"474","cpn1567",2,1,0,1
"475","cpn1569",2,0,0,2
"477","cpn1570",1,0,0,1
"478","cpn1571",1,0,0,1
"479","cpn1572",2,1,0,1
"480","cpn1574",2,0,0,2
"481","cpn1575",1,0,0,1
"482","cpn1578",4,0,0,4
"483","cpn1579",3,3,0,0
"485","cpn1582",1,1,0,0
"486","cpn1583",2,0,0,2
"487","cpn1584",1,0,0,1
"488","cpn1586",1,1,0,0
"489","cpn1587",3,1,0,2
"490","cpn1588",1,1,0,0
"491","cpn1589",1,0,0,1
"493","cpn1590",2,1,0,1
"494","cpn1591",1,0,0,1
"495","cpn1594",4,0,0,4
"496","cpn1595",1,0,0,1
"497","cpn1597",1,1,0,0
"498","cpn1599",4,1,0,3
"501","cpn1600",1,0,0,1
"502","cpn1602",2,1,0,1
"503","cpn1603",3,1,0,2
"504","cpn1604",2,0,0,2
"505","cpn1607",1,0,0,1
"506","cpn1608",1,0,0,1
"507","cpn1609",1,0,0,1
"509","cpn1611",1,0,0,1
"510","cpn1612",1,0,0,1
"511","cpn1613",1,0,0,1
"512","cpn1614",1,0,0,1
"513","cpn1615",3,0,0,3
"514","cpn1617",1,0,0,1
"515","cpn1619",1,0,0,1
"517","cpn1620",1,1,0,0
"518","cpn1621",2,0,0,2
"519","cpn1624",1,0,0,1
"520","cpn1627",1,0,0,1
"522","cpn1631",2,0,0,2
"523","cpn1633",1,0,0,1
"524","cpn1637",1,0,0,1
"525","cpn1638",1,0,0,1
"527","cpn1641",1,0,0,1
"528","cpn1642",2,0,0,2
"529","cpn1643",2,1,0,1
"530","cpn1645",1,0,0,1
"531","cpn1647",3,0,0,3
"532","cpn1648",3,0,0,3
"533","cpn1649",1,0,0,1
"535","cpn1650",1,0,0,1
"536","cpn1651",3,1,0,2
"537","cpn1653",2,0,0,2
"538","cpn1654",1,0,0,1
"539","cpn1655",2,1,0,1
"541","cpn1660",2,0,0,2
"542","cpn1661",1,0,0,1
"543","cpn1664",3,1,0,2
"544","cpn1665",3,1,0,2
"545","cpn1667",1,0,0,1
"546","cpn1669",1,0,0,1
"548","cpn1670",3,0,0,3
"549","cpn1672",1,0,0,1
"550","cpn1675",1,0,0,1
"551","cpn1676",2,1,0,1
"552","cpn1678",2,1,0,1
"553","cpn1679",1,0,0,1
"555","cpn1680",1,0,0,1
"556","cpn1681",1,0,0,1
"557","cpn1682",1,0,0,1
"558","cpn1683",2,2,0,0
"559","cpn1684",1,1,0,0
"560","cpn1685",1,0,0,1
"561","cpn1686",1,0,0,1
"562","cpn1689",3,1,0,2
"563","cpn1691",2,1,0,1
"564","cpn1692",2,1,0,1
"565","cpn1693",6,3,0,3
"566","cpn1694",1,0,0,1
"567","cpn1695",1,0,0,1
"570","cpn1703",2,0,0,2
"571","cpn1708",2,0,0,2
"572","cpn1709",2,0,0,2
"574","cpn1710",1,0,0,1
"575","cpn1711",1,0,0,1
"576","cpn1712",1,0,0,1
"577","cpn1713",1,0,0,1
"578","cpn1714",1,0,0,1
"579","cpn1715",2,1,0,1
"580","cpn1717",1,0,0,1
"581","cpn1718",1,0,0,1
"582","cpn1719",2,1,0,1
"584","cpn1720",8,1,0,7
"585","cpn1723",1,0,0,1
"586","cpn1724",1,0,0,1
"587","cpn1729",1,0,0,1
"588","cpn1731",1,0,0,1
"589","cpn1732",1,0,0,1
"590","cpn1733",2,1,0,1
"591","cpn1734",1,1,0,0
"592","cpn1735",2,0,0,2
"593","cpn1736",2,0,0,2
"594","cpn1737",3,1,0,2
"595","cpn1738",1,0,0,1
"597","cpn1740",1,0,0,1
"598","cpn1741",1,0,0,1
"599","cpn1742",1,0,0,1
"600","cpn1747",2,1,0,1
"601","cpn1748",1,0,0,1
"602","cpn1749",1,1,0,0
"603","cpn1750",1,0,0,1
"604","cpn1751",1,0,0,1
"605","cpn1752",2,1,0,1
"606","cpn1753",1,0,0,1
"607","cpn1755",3,1,0,2
"608","cpn1757",1,0,0,1
"609","cpn1758",5,1,0,4
"611","cpn1761",1,0,0,1
"612","cpn1762",1,0,0,1
"613","cpn1763",1,0,0,1
"614","cpn1764",1,0,0,1
"615","cpn1767",1,0,0,1
"616","cpn1768",1,0,0,1
"618","cpn1770",6,1,0,5
"619","cpn1771",2,0,0,2
"620","cpn1774",2,0,0,2
"621","cpn1775",3,0,0,3
"622","cpn1777",1,0,0,1
"623","cpn1779",2,1,0,1
"625","cpn1780",1,1,0,0
"626","cpn1788",4,2,0,2
"628","cpn1790",3,0,0,3
"629","cpn1792",2,0,0,2
"630","cpn1793",1,1,0,0
"631","cpn1794",1,0,0,1
"632","cpn1795",1,0,0,1
"633","cpn1796",3,0,0,3
"634","cpn1799",1,0,0,1
"637","cpn1800",2,1,0,1
"638","cpn1801",1,1,0,0
"639","cpn1802",1,0,0,1
"640","cpn1803",1,0,0,1
"641","cpn1805",4,0,0,4
"643","cpn1810",1,1,0,0
"644","cpn1811",1,0,0,1
"645","cpn1814",2,2,0,0
"646","cpn1815",3,0,0,3
"647","cpn1816",1,0,0,1
"648","cpn1818",1,0,0,1
"649","cpn1823",1,0,0,1
"650","cpn1824",1,0,0,1
"651","cpn1825",3,1,0,2
"652","cpn1826",1,0,0,1
"653","cpn1828",1,0,0,1
"654","cpn1833",1,0,0,1
"655","cpn1837",2,0,0,2
"656","cpn1839",3,0,0,3
"658","cpn1840",2,1,0,1
"659","cpn1842",2,0,0,2
"660","cpn1843",1,0,0,1
"661","cpn1844",1,0,0,1
"662","cpn1846",1,0,0,1
"663","cpn1848",4,0,0,4
"665","cpn1852",2,0,0,2
"666","cpn1853",2,1,0,1
"667","cpn1860",1,0,0,1
"668","cpn1861",1,0,0,1
"669","cpn1862",1,1,0,0
"670","cpn1863",1,0,0,1
"671","cpn1867",1,0,0,1
"672","cpn1869",1,0,0,1
"674","cpn1870",1,0,0,1
"675","cpn1871",1,0,0,1
"676","cpn1875",1,1,0,0
"677","cpn1876",1,0,0,1
"678","cpn1878",1,0,0,1
"679","cpn1879",3,2,0,1
"681","cpn1880",2,0,0,2
"682","cpn1881",2,1,0,1
"683","cpn1883",1,0,0,1
"684","cpn1884",1,0,0,1
"685","cpn1887",2,1,0,1
"686","cpn1888",2,0,0,2
"687","cpn1889",1,0,0,1
"689","cpn1890",1,0,0,1
"690","cpn1891",1,1,0,0
"691","cpn1895",2,1,0,1
"692","cpn1896",1,0,0,1
"693","cpn1897",1,0,0,1
"696","cpn1900",2,2,0,0
"697","cpn1901",1,0,0,1
"698","cpn1906",1,0,0,1
"699","cpn1907",4,2,0,2
"700","cpn1908",3,2,0,1
"701","cpn1909",1,1,0,0
"703","cpn1910",1,0,0,1
"704","cpn1911",1,0,0,1
"705","cpn1912",1,0,0,1
"706","cpn1913",1,0,0,1
"707","cpn1914",2,0,0,2
"708","cpn1915",2,2,0,0
"709","cpn1917",1,1,0,0
"710","cpn1922",3,0,0,3
"711","cpn1923",1,0,0,1
"712","cpn1924",3,1,0,2
"713","cpn1925",2,0,0,2
"714","cpn1927",2,0,0,2
"716","cpn1930",1,0,0,1
"717","cpn1934",1,0,0,1
"718","cpn1935",2,1,0,1
"719","cpn1938",2,1,0,1
"720","cpn1939",4,1,0,3
"722","cpn1943",1,0,0,1
"723","cpn1945",1,0,0,1
"724","cpn1947",1,1,0,0
"725","cpn1948",1,1,0,0
"727","cpn1951",3,1,0,2
"728","cpn1952",2,1,0,1
"729","cpn1956",2,0,0,2
"730","cpn1957",2,1,0,1
"731","cpn1958",1,0,0,1
"732","cpn1959",2,0,0,2
"734","cpn1960",1,1,0,0
"735","cpn1963",2,0,0,2
"736","cpn1964",1,0,0,1
"737","cpn1966",2,0,0,2
"738","cpn1967",3,0,0,3
"739","cpn1968",1,0,0,1
"740","cpn1969",2,0,0,2
"742","cpn1972",2,1,0,1
"743","cpn1979",1,0,0,1
"745","cpn1980",1,0,0,1
"746","cpn1981",1,0,0,1
"747","cpn1985",1,0,0,1
"748","cpn1987",1,0,0,1
"749","cpn1988",1,1,0,0
"750","cpn1989",1,0,0,1
"752","cpn1990",3,1,0,2
"753","cpn1991",3,1,0,2
"754","cpn1992",2,0,0,2
"755","cpn1994",1,1,0,0
"756","cpn1995",3,2,1,1
"757","cpn1996",4,4,0,0
"758","cpn1997",1,1,0,0
"759","cpn1998",3,1,0,2
"762","cpn2000",1,1,0,0
"763","cpn2002",2,0,0,2
"764","cpn2003",1,0,0,1
"765","cpn2004",1,1,0,0
"766","cpn2006",1,0,0,1
"767","cpn2007",1,0,0,1
"768","cpn2008",1,0,0,1
"769","cpn2009",1,0,0,1
"771","cpn2012",1,0,0,1
"772","cpn2014",3,1,0,2
"773","cpn2015",1,1,0,0
"774","cpn2019",5,1,0,4
"775","cpn2021",6,0,0,6
"776","cpn2022",1,0,0,1
"777","cpn2024",1,1,0,0
"778","cpn2025",1,1,0,0
"779","cpn2026",3,1,0,2
"780","cpn2027",1,0,0,1
"781","cpn2029",1,1,0,0
"783","cpn2030",2,2,0,0
"784","cpn2031",1,0,0,1
"785","cpn2032",1,0,0,1
"786","cpn2034",1,1,0,0
"787","cpn2035",2,0,0,2
"788","cpn2036",1,0,0,1
"789","cpn2037",1,1,0,0
"790","cpn2038",2,0,0,2
"792","cpn2041",2,0,0,2
"793","cpn2045",1,0,0,1
"794","cpn2046",1,1,0,0
"795","cpn2047",2,1,0,1
"796","cpn2048",2,0,0,2
"797","cpn2049",2,1,0,1
"799","cpn2052",1,0,0,1
"800","cpn2053",2,1,0,1
"801","cpn2054",1,0,0,1
"802","cpn2055",3,0,0,3
"803","cpn2056",3,0,0,3
"804","cpn2059",1,1,0,0
"806","cpn2060",3,0,0,3
"807","cpn2061",3,1,0,2
"808","cpn2062",2,0,0,2
"809","cpn2063",1,0,0,1
"810","cpn2064",1,1,0,0
"811","cpn2066",2,0,0,2
"812","cpn2067",2,0,0,2
"813","cpn2069",1,0,0,1
"815","cpn2074",1,0,0,1
"816","cpn2075",1,0,0,1
"817","cpn2076",2,0,0,2
"819","cpn2081",5,2,0,3
"820","cpn2083",1,0,0,1
"821","cpn2085",1,1,0,0
"822","cpn2086",2,1,0,1
"823","cpn2089",2,0,0,2
"825","cpn2093",2,0,0,2
"826","cpn2094",4,2,0,2
"827","cpn2095",4,2,0,2
"828","cpn2096",1,0,0,1
"829","cpn2099",1,0,0,1
"832","cpn2103",2,1,0,1
"833","cpn2104",2,0,0,2
"834","cpn2105",1,1,0,0
"835","cpn2106",1,1,0,0
"836","cpn2107",2,0,0,2
"837","cpn2108",1,0,0,1
"838","cpn2109",1,0,0,1
"840","cpn2111",1,1,0,0
"841","cpn2112",1,0,0,1
"842","cpn2114",2,1,0,1
"843","cpn2116",1,0,0,1
"844","cpn2119",1,0,0,1
"846","cpn2123",2,2,0,0
"847","cpn2124",1,0,0,1
"848","cpn2127",2,2,0,0
"849","cpn2128",2,0,0,2
"851","cpn2132",2,0,0,2
"852","cpn2135",1,0,0,1
"853","cpn2138",1,1,0,0
"854","cpn2141",1,0,0,1
"855","cpn2142",3,0,0,3
"856","cpn2146",1,0,0,1
"857","cpn2147",1,1,0,0
"858","cpn2149",2,0,0,2
"860","cpn2151",2,0,0,2
"861","cpn2152",1,0,0,1
"862","cpn2153",1,0,0,1
"863","cpn2154",1,0,0,1
"864","cpn2155",2,0,0,2
"865","cpn2156",1,0,0,1
"866","cpn2157",1,0,0,1
"867","cpn2158",1,0,0,1
"868","cpn2159",1,0,0,1
"870","cpn2161",2,0,0,2
"871","cpn2162",1,0,0,1
"872","cpn2168",1,0,0,1
"873","cpn2169",2,0,0,2
"875","cpn2170",1,0,0,1
"876","cpn2171",1,0,0,1
"877","cpn2172",1,0,0,1
"878","cpn2174",1,0,0,1
"879","cpn2176",1,0,0,1
"880","cpn2177",2,1,0,1
"881","cpn2178",1,0,0,1
"882","cpn2179",2,0,0,2
"884","cpn2180",1,1,0,0
"885","cpn2181",1,0,0,1
"886","cpn2184",4,1,0,3
"887","cpn2185",1,0,0,1
"888","cpn2188",1,0,0,1
"890","cpn2190",1,0,0,1
"891","cpn2191",1,0,0,1
"892","cpn2192",3,1,0,2
"893","cpn2193",3,0,0,3
"894","cpn2194",4,0,0,4
"895","cpn2197",1,0,0,1
"896","cpn2198",1,0,0,1
"899","cpn2201",1,1,0,0
"900","cpn2202",3,0,0,3
"901","cpn2203",1,0,0,1
"902","cpn2204",1,0,0,1
"903","cpn2207",1,1,0,0
"904","cpn2208",1,0,0,1
"905","cpn2209",1,0,0,1
"906","cpn2210",1,0,0,1
"907","cpn2213",2,0,0,2
"908","cpn2214",1,1,0,0
"909","cpn2215",1,0,0,1
"910","cpn2216",1,1,0,0
"911","cpn2217",1,0,0,1
"912","cpn2219",1,1,0,0
"914","cpn2221",1,0,0,1
"915","cpn2225",1,0,0,1
"916","cpn2226",1,0,0,1
"917","cpn2227",1,0,0,1
"918","cpn2232",1,0,0,1
"919","cpn2234",2,0,0,2
"920","cpn2236",1,0,0,1
"921","cpn2237",1,0,0,1
"923","cpn2242",1,0,0,1
"924","cpn2243",1,0,0,1
"925","cpn2244",1,0,0,1
"926","cpn2245",1,0,0,1
"927","cpn2246",1,0,0,1
"928","cpn2247",1,0,0,1
"929","cpn2248",2,1,0,1
"931","cpn2251",3,0,0,3
"932","cpn2252",2,0,0,2
"933","cpn2253",1,0,0,1
"934","cpn2254",1,0,0,1
"935","cpn2255",1,0,0,1
"936","cpn2256",1,0,0,1
"937","cpn2257",1,0,0,1
"938","cpn2259",3,1,0,2
"940","cpn2260",4,1,0,3
"941","cpn2263",1,0,0,1
"942","cpn2266",1,0,0,1
"944","cpn2274",1,0,0,1
"945","cpn2275",1,1,0,0
"946","cpn2279",1,0,0,1
"948","cpn2281",2,1,0,1
"949","cpn2284",2,0,0,2
"950","cpn2285",1,1,0,0
"951","cpn2287",1,0,0,1
"953","cpn2295",1,1,0,0
"954","cpn2296",1,0,0,1
"955","cpn2297",3,0,0,3
"958","cpn2301",1,0,0,1
"959","cpn2303",1,0,0,1
"960","cpn2304",1,0,0,1
"961","cpn2308",1,0,0,1
"963","cpn2313",1,0,0,1
"964","cpn2314",1,0,0,1
"965","cpn2315",1,0,0,1
"966","cpn2317",2,1,0,1
"967","cpn2318",1,0,0,1
"968","cpn2319",1,0,0,1
"970","cpn2320",1,0,0,1
"971","cpn2324",4,0,0,4
"972","cpn2325",1,1,0,0
"973","cpn2326",1,0,0,1
"974","cpn2327",1,0,0,1
"975","cpn2328",1,0,0,1
"977","cpn2333",1,0,0,1
"978","cpn2335",2,0,0,2
"979","cpn2336",1,0,0,1
"980","cpn2337",1,0,0,1
"981","cpn2338",1,0,0,1
"982","cpn2339",2,0,0,2
"983","cpn2340",1,1,0,0
"984","cpn2341",1,0,0,1
"985","cpn2343",2,0,0,2
"986","cpn2344",1,1,0,0
"987","cpn2347",2,0,0,2
"988","cpn2348",1,0,0,1
"989","cpn2349",2,1,0,1
"990","cpn2351",2,1,0,1
"991","cpn2352",1,1,0,0
"992","cpn2354",1,0,0,1
"993","cpn2355",1,0,0,1
"994","cpn2356",2,0,0,2
"995","cpn2358",1,0,0,1
"996","cpn2359",3,1,0,2
"998","cpn2363",1,0,0,1
"999","cpn2368",1,0,0,1
"1001","cpn2371",1,0,0,1
"1002","cpn2375",1,0,0,1
"1003","cpn2377",2,0,0,2
"1004","cpn2380",4,0,0,4
"1005","cpn2381",1,0,0,1
"1006","cpn2382",1,0,0,1
"1007","cpn2384",1,0,0,1
"1008","cpn2386",2,1,0,1
"1009","cpn2388",2,0,0,2
"1010","cpn2389",1,0,0,1
"1012","cpn2393",3,2,0,1
"1013","cpn2394",1,0,0,1
"1014","cpn2395",1,0,0,1
"1015","cpn2396",2,0,0,2
"1016","cpn2397",1,0,0,1
"1017","cpn2399",1,0,0,1
"1020","cpn2400",1,1,0,0
"1021","cpn2401",3,1,0,2
"1022","cpn2403",1,1,0,0
"1023","cpn2404",1,0,0,1
"1024","cpn2405",1,0,0,1
"1025","cpn2406",1,0,0,1
"1026","cpn2407",1,0,0,1
"1027","cpn2409",2,1,0,1
"1028","cpn2410",1,0,0,1
"1029","cpn2413",1,1,0,0
"1030","cpn2414",1,0,0,1
"1031","cpn2415",1,0,0,1
"1032","cpn2416",1,0,0,1
"1033","cpn2418",1,1,0,0
"1034","cpn2421",1,0,0,1
"1035","cpn2422",2,0,0,2
"1036","cpn2423",1,0,0,1
"1037","cpn2424",2,1,0,1
"1038","cpn2427",1,0,0,1
"1039","cpn2429",3,1,0,2
"1041","cpn2430",1,0,0,1
"1042","cpn2437",1,0,0,1
"1043","cpn2438",11,3,0,8
"1044","cpn2439",2,2,0,0
"1046","cpn2442",1,0,0,1
"1047","cpn2443",1,0,0,1
"1048","cpn2444",1,0,0,1
"1049","cpn2445",1,0,0,1
"1050","cpn2446",5,0,0,5
"1051","cpn2447",3,1,0,2
"1052","cpn2448",1,0,0,1
"1053","cpn2449",2,1,0,1
"1055","cpn2450",1,1,0,0
"1056","cpn2451",1,0,0,1
"1057","cpn2453",1,0,0,1
"1058","cpn2454",2,0,0,2
"1059","cpn2458",1,0,0,1
"1060","cpn2459",2,0,0,2
"1062","cpn2462",1,0,0,1
"1063","cpn2465",1,0,0,1
"1064","cpn2466",2,0,0,2
"1065","cpn2468",1,0,0,1
"1066","cpn2469",2,1,1,1
"1068","cpn2473",1,0,0,1
"1069","cpn2474",2,2,0,0
"1070","cpn2476",1,0,0,1
"1071","cpn2477",1,0,0,1
"1072","cpn2479",1,0,0,1
"1074","cpn2482",3,1,0,2
"1075","cpn2487",1,1,0,0
"1076","cpn2488",1,1,0,0
"1078","cpn2490",1,0,0,1
"1079","cpn2491",1,0,0,1
"1080","cpn2492",1,0,0,1
"1081","cpn2493",1,0,0,1
"1082","cpn2494",2,0,0,2
"1083","cpn2495",1,0,0,1
"1084","cpn2497",1,0,0,1
"1085","cpn2498",2,0,0,2
"1088","cpn2501",1,0,0,1
"1089","cpn2502",1,1,0,0
"1090","cpn2506",1,0,0,1
"1091","cpn2507",1,0,0,1
"1092","cpn2508",1,0,0,1
"1094","cpn2513",1,0,0,1
"1096","cpn2520",1,0,0,1
"1097","cpn2522",2,0,0,2
"1098","cpn2523",1,0,0,1
"1099","cpn2526",1,1,0,0
"1101","cpn2530",1,0,0,1
"1102","cpn2532",2,0,0,2
"1103","cpn2533",2,0,0,2
"1105","cpn2540",1,0,0,1
"1106","cpn2542",1,1,0,0
"1107","cpn2545",1,0,0,1
"1108","cpn2547",2,0,0,2
"1109","cpn2549",1,0,0,1
"1111","cpn2552",2,0,0,2
"1112","cpn2553",1,0,0,1
"1113","cpn2554",1,0,0,1
"1114","cpn2555",1,0,0,1
"1115","cpn2556",1,0,0,1
"1116","cpn2559",2,0,0,2
"1118","cpn2560",1,0,0,1
"1119","cpn2562",1,0,0,1
"1120","cpn2564",1,0,0,1
"1121","cpn2565",1,0,0,1
"1122","cpn2567",1,0,0,1
"1123","cpn2568",1,0,0,1
"1124","cpn2569",1,0,0,1
"1126","cpn2570",1,0,0,1
"1127","cpn2571",2,0,0,2
"1128","cpn2572",1,0,0,1
"1129","cpn2574",2,0,0,2
"1130","cpn2575",1,0,0,1
"1131","cpn2577",2,0,0,2
"1132","cpn2578",1,1,0,0
"1133","cpn2579",3,1,0,2
"1135","cpn2586",1,0,0,1
"1137","cpn2593",1,0,0,1
"1138","cpn2596",1,0,0,1
"1139","cpn2599",1,0,0,1
"1142","cpn2600",2,0,0,2
"1143","cpn2601",1,0,0,1
"1144","cpn2602",1,0,0,1
"1145","cpn2606",1,0,0,1
"1146","cpn2607",1,1,0,0
"1147","cpn2608",1,0,0,1
"1148","cpn2609",3,0,0,3
"1150","cpn2610",1,0,0,1
"1151","cpn2616",1,0,0,1
"1152","cpn2617",2,1,0,1
"1153","cpn2618",4,0,0,4
"1155","cpn2620",1,0,0,1
"1156","cpn2622",1,0,0,1
"1157","cpn2623",1,0,0,1
"1158","cpn2625",1,1,0,0
"1159","cpn2626",1,0,0,1
"1160","cpn2627",2,0,0,2
"1161","cpn2629",2,0,0,2
"1163","cpn2630",1,0,0,1
"1164","cpn2631",1,0,0,1
"1165","cpn2632",1,0,0,1
"1166","cpn2635",1,0,0,1
"1167","cpn2636",1,0,0,1
"1169","cpn2641",1,0,0,1
"1170","cpn2642",2,0,0,2
"1171","cpn2643",11,4,0,7
"1172","cpn2644",1,0,0,1
"1173","cpn2645",1,1,0,0
"1174","cpn2646",1,0,0,1
"1175","cpn2647",5,1,0,4
"1177","cpn2650",2,1,0,1
"1178","cpn2653",3,0,0,3
"1179","cpn2654",1,1,0,0
"1180","cpn2658",1,0,0,1
"1182","cpn2660",1,0,0,1
"1183","cpn2661",1,0,0,1
"1184","cpn2664",1,1,0,0
"1185","cpn2668",1,0,0,1
"1186","cpn2669",1,0,0,1
"1188","cpn2671",1,1,0,0
"1189","cpn2675",1,0,0,1
"1190","cpn2676",1,0,0,1
"1191","cpn2678",1,0,0,1
"1192","cpn2679",4,1,0,3
"1194","cpn2680",1,0,0,1
"1195","cpn2681",1,0,0,1
"1196","cpn2683",1,1,0,0
"1197","cpn2684",1,0,0,1
"1199","cpn2690",1,0,0,1
"1200","cpn2691",1,1,0,0
"1201","cpn2696",4,0,0,4
"1202","cpn2697",1,0,0,1
"1203","cpn2698",1,1,0,0
"1205","cpn2701",1,1,0,0
"1206","cpn2702",1,1,0,0
"1207","cpn2703",1,0,0,1
"1208","cpn2704",1,0,0,1
"1209","cpn2705",1,0,0,1
"1210","cpn2708",1,0,0,1
"1211","cpn2709",1,0,0,1
"1212","cpn2711",3,2,0,1
"1213","cpn2712",1,0,0,1
"1214","cpn2713",1,0,0,1
"1215","cpn2715",1,0,0,1
"1216","cpn2717",1,0,0,1
"1217","cpn2718",1,1,0,0
"1218","cpn2719",1,1,0,0
"1220","cpn2720",3,1,0,2
"1221","cpn2722",1,0,0,1
"1222","cpn2723",1,0,0,1
"1223","cpn2724",1,1,0,0
"1224","cpn2725",1,0,0,1
"1225","cpn2726",1,1,0,0
"1226","cpn2728",1,0,0,1
"1228","cpn2730",1,0,0,1
"1229","cpn2731",5,3,0,2
"1230","cpn2733",2,0,0,2
"1232","cpn2741",2,0,0,2
"1233","cpn2747",1,0,0,1
"1235","cpn2756",1,0,0,1
"1236","cpn2757",2,0,0,2
"1237","cpn2758",2,0,0,2
"1239","cpn2760",1,0,0,1
"1240","cpn2761",1,0,0,1
"1241","cpn2762",1,0,0,1
"1242","cpn2763",2,0,0,2
"1243","cpn2766",1,0,0,1
"1244","cpn2768",1,0,0,1
"1245","cpn2769",3,0,0,3
"1247","cpn2773",1,1,0,0
"1248","cpn2774",2,2,0,0
"1249","cpn2775",1,0,0,1
"1250","cpn2776",1,0,0,1
"1252","cpn2784",1,0,0,1
"1253","cpn2785",1,0,0,1
"1254","cpn2789",1,0,0,1
"1256","cpn2790",2,1,0,1
"1257","cpn2791",2,0,0,2
"1258","cpn2794",4,0,0,4
"1259","cpn2797",1,0,0,1
"1262","cpn2801",1,0,0,1
"1263","cpn2807",1,0,0,1
"1264","cpn2808",1,0,0,1
"1265","cpn2809",1,0,0,1
"1267","cpn2812",1,0,0,1
"1268","cpn2813",1,0,0,1
"1269","cpn2819",1,0,0,1
"1270","cpn2822",2,1,1,1
"1271","cpn2823",1,1,0,0
"1272","cpn2828",2,0,0,2
"1274","cpn2830",1,1,0,0
"1275","cpn2832",1,0,0,1
"1276","cpn2834",2,0,0,2
"1277","cpn2838",4,1,0,3
"1279","cpn2842",1,0,0,1
"1280","cpn2848",1,0,0,1
"1281","cpn2849",1,1,0,0
"1282","cpn2850",1,0,0,1
"1283","cpn2851",1,0,0,1
"1284","cpn2854",1,0,0,1
"1285","cpn2857",1,0,0,1
"1286","cpn2865",1,0,0,1
"1287","cpn2867",1,0,0,1
"1288","cpn2868",2,0,0,2
"1289","cpn2872",1,0,0,1
"1290","cpn2874",1,1,0,0
"1291","cpn2875",1,0,0,1
"1292","cpn2876",1,0,0,1
"1293","cpn2879",1,0,0,1
"1295","cpn2882",1,0,0,1
"1296","cpn2888",2,1,0,1
"1297","cpn2889",4,0,0,4
"1299","cpn2890",2,2,0,0
"1300","cpn2896",2,0,0,2
"1301","cpn2897",1,0,0,1
"1303","cpn2900",1,0,0,1
"1304","cpn2901",3,1,0,2
"1305","cpn2906",1,0,0,1
"1306","cpn2907",1,0,0,1
"1308","cpn2910",1,1,0,0
"1309","cpn2911",1,0,0,1
"1310","cpn2912",1,0,0,1
"1311","cpn2913",1,0,0,1
"1312","cpn2917",1,0,0,1
"1314","cpn2921",1,0,0,1
"1315","cpn2924",1,1,0,0
"1316","cpn2925",1,0,0,1
"1317","cpn2926",1,0,0,1
"1319","cpn2930",1,1,0,0
"1320","cpn2931",1,0,0,1
"1321","cpn2932",2,0,0,2
"1322","cpn2933",2,0,0,2
"1323","cpn2934",1,1,0,0
"1324","cpn2935",1,0,0,1
"1325","cpn2936",1,0,0,1
"1326","cpn2938",1,0,0,1
"1327","cpn2939",2,0,0,2
"1329","cpn2942",1,0,0,1
"1330","cpn2944",1,0,0,1
"1331","cpn2948",1,0,0,1
"1332","cpn2949",1,0,0,1
"1334","cpn2950",1,0,0,1
"1335","cpn2951",1,0,0,1
"1336","cpn2952",1,0,0,1
"1337","cpn2953",1,0,0,1
"1338","cpn2956",1,0,0,1
"1339","cpn2958",1,1,0,0
"1340","cpn2959",2,1,0,1
"1342","cpn2960",1,1,0,0
"1343","cpn2961",2,0,0,2
"1345","cpn2974",1,0,0,1
"1346","cpn2975",1,0,0,1
"1347","cpn2977",1,0,0,1
"1348","cpn2978",1,1,0,0
"1350","cpn2982",1,0,0,1
"1351","cpn2988",1,1,0,0
"1353","cpn2990",1,0,0,1
"1354","cpn2992",1,0,0,1
"1355","cpn2995",1,0,0,1
"1356","cpn2997",1,0,0,1
"1357","cpn2999",2,1,0,1
"1361","cpn3002",1,0,0,1
"1362","cpn3003",1,0,0,1
"1364","cpn3018",1,1,0,0
"1366","cpn3022",2,0,0,2
"1367","cpn3023",1,1,0,0
"1368","cpn3024",1,0,0,1
"1369","cpn3027",1,0,0,1
"1370","cpn3028",1,0,0,1
"1371","cpn3030",1,0,0,1
"1372","cpn3031",1,0,0,1
"1373","cpn3032",1,0,0,1
"1374","cpn3033",2,0,0,2
"1375","cpn3036",1,0,0,1
"1376","cpn3044",1,0,0,1
"1377","cpn3046",1,1,0,0
"1378","cpn3047",1,1,0,0
"1379","cpn3049",1,0,0,1
"1381","cpn3052",1,0,0,1
"1382","cpn3053",1,0,0,1
"1383","cpn3054",1,0,0,1
"1385","cpn3065",1,0,0,1
"1386","cpn3068",2,1,0,1
"1388","cpn3071",1,0,0,1
"1389","cpn3075",2,0,0,2
"1390","cpn3076",1,1,0,0
"1391","cpn3078",1,0,0,1
"1392","cpn3079",1,0,0,1
"1394","cpn3082",2,1,0,1
"1395","cpn3083",1,0,0,1
"1396","cpn3084",1,0,0,1
"1398","cpn3090",1,0,0,1
"1399","cpn3092",2,2,1,0
"1400","cpn3095",1,1,0,0
"1401","cpn3098",1,0,0,1
"1403","cpn3100",2,0,0,2
"1404","cpn3101",1,0,0,1
"1405","cpn3102",1,0,0,1
"1406","cpn3103",1,0,0,1
"1407","cpn3105",1,0,0,1
"1409","cpn3110",1,0,0,1
"1410","cpn3111",1,0,0,1
"1411","cpn3118",1,1,0,0
"1413","cpn3121",1,0,0,1
"1414","cpn3122",1,0,0,1
"1415","cpn3123",2,0,0,2
"1416","cpn3126",1,0,0,1
"1417","cpn3127",1,0,0,1
"1418","cpn3128",1,0,0,1
"1419","cpn3133",1,0,0,1
"1420","cpn3134",1,0,0,1
"1421","cpn3135",1,0,0,1
"1422","cpn3136",1,1,0,0
"1424","cpn3142",1,0,0,1
"1425","cpn3150",1,0,0,1
"1426","cpn3153",1,0,0,1
"1427","cpn3154",1,0,0,1
"1428","cpn3156",1,0,0,1
"1429","cpn3157",1,1,0,0
"1430","cpn3158",1,0,0,1
"1431","cpn3159",1,0,0,1
"1432","cpn3160",1,0,0,1
"1433","cpn3161",1,0,0,1
"1434","cpn3163",1,0,0,1
"1435","cpn3166",1,0,0,1
"1436","cpn3167",1,0,0,1
"1437","cpn3168",1,0,0,1
"1438","cpn3169",1,0,0,1
"1439","cpn3171",1,0,0,1
"1440","cpn3179",1,1,0,0
"1442","cpn3181",1,0,0,1
"1443","cpn3183",1,0,0,1
"1444","cpn3186",1,0,0,1
"1445","cpn3187",1,0,0,1
"1447","cpn3190",1,0,0,1
"1448","cpn3194",1,0,0,1
"1449","cpn3195",1,0,0,1
"1452","cpn3201",1,1,0,0
"1453","cpn3202",1,0,0,1
"1454","cpn3207",1,0,0,1
"1455","cpn3208",1,0,0,1
"1456","cpn3209",1,0,0,1
"1458","cpn3210",1,0,0,1
"1459","cpn3211",1,1,0,0
"1460","cpn3213",1,0,0,1
"1461","cpn3217",1,0,0,1
"1463","cpn3220",1,0,0,1
"1464","cpn3223",1,1,0,0
"1465","cpn3227",1,1,0,0
"1466","cpn3228",1,1,0,0
"1468","cpn3231",1,0,0,1
"1469","cpn3232",1,1,0,0
"1470","cpn3238",2,0,0,2
"1471","cpn3245",1,0,0,1
"1472","cpn3246",1,0,0,1
"1474","cpn3253",1,0,0,1
"1475","cpn3254",1,0,0,1
"1476","cpn3256",1,0,0,1
"1477","cpn3259",1,1,0,0
"1479","cpn3260",1,0,0,1
"1480","cpn3266",1,0,0,1
"1481","cpn3267",1,0,0,1
"1482","cpn3268",1,0,0,1
"1483","cpn3269",1,0,0,1
"1485","cpn3273",1,0,0,1
"1486","cpn3274",1,0,0,1
"1487","cpn3275",1,0,0,1
"1488","cpn3276",1,0,0,1
"1489","cpn3278",1,0,0,1
"1491","cpn3281",1,0,0,1
"1492","cpn3284",1,0,0,1
"1493","cpn3289",1,0,0,1
"1495","cpn3296",2,0,0,2
"1496","cpn3297",1,0,0,1
"1498","cpn3304",1,0,0,1
"1499","cpn3305",1,0,0,1
"1500","cpn3308",1,1,0,0
"1502","cpn3311",1,0,0,1
"1503","cpn3312",1,0,0,1
"1504","cpn3315",1,1,0,0
"1505","cpn3316",1,1,0,0
"1507","cpn3320",1,1,0,0
"1508","cpn3321",1,0,0,1
"1509","cpn3324",1,0,0,1
"1510","cpn3325",1,0,0,1
"1511","cpn3327",1,0,0,1
"1512","cpn3329",1,0,0,1
"1513","cpn3332",1,0,0,1
"1514","cpn3334",1,0,0,1
"1515","cpn3336",1,0,0,1
"1516","cpn3337",1,0,0,1
"1517","cpn3339",1,0,0,1
"1518","cpn3340",1,0,0,1
"1519","cpn3344",1,1,0,0
"1520","cpn3345",1,1,0,0
